Mwathani Ngai Wa Isiraeli(376)
(Benedictus)

1.Mwathani Ngai wa Isiraeli |aro|kumio:tondũ
  Nĩokire kũrora andũ |ake a|kama|kũũra.

2.Agatũtũgĩria rũhĩa rũa kũ|hono|kania:ruumĩte
  Nyũmbainĩ ya Dau|di ndu|ngata |yake.

3.O ta ũrĩa aanoiga na tũnua twa anabii| ake
  A|theru: kuu|ma o |kĩambĩ|rĩria.

4.Nĩguo tũhonokio kũ|rĩ thũ | ciitũ: na kũrĩ a|rĩa
  Ma|tũme|naga.

5.Nĩ getha aiguĩre ma|ithe mai|tũ tha: na
  Aririkane kĩrĩkanĩ|ro gĩa|ke gĩ|theru.

6.Naguo mwĩhĩtwa ũrĩa | ehĩ|tĩire: Ibura|himu,
  |Ithe | witũ.

7.Atĩ nĩagatwĩtĩkĩra,
  Twarĩkia kũhonoka mokoinĩ |ma thũ |ciitũ:
  Tũcoke tũmũtungatagĩre | tũta|rĩ na |guoya.

8.Na tũtũũre mbere yake matukũ | maitũ
  | Mothe: tũrĩ a|theru na |tũrĩ a|thingu.

9.O nawe, kaana gaka, nĩũgatuwo
  Mũnabii wa ũrĩa-wĩ-|Igũrũ-|muno: nĩ
  Gũkorũo nĩũgathiaga mbere ya
  Mwathani, nĩguo ũkamũthondeka|gĩre|
  Njĩra | ciake.

10.ũtũme andũ ake mamenyithio ũhoro
  Wa| kũho|nokio: nĩ ũndũ wa |kuo|
  herũo |mehia |mao.

11.Tondũ wa tha iria cia | Ngai | witũ: nz
  Nĩ ũndũ wacio ũrĩa wĩtagwo Gũkĩa-
  Kuumĩte-Igũrũ nĩagoka |gũtũ|rora.

12.Nĩ getha aarĩre andũ arĩa maikarĩte
  Ndumainĩ na kĩĩgunyĩi|nĩ gĩa | gĩkiũ:
  Na arũngĩrĩrie magũrũ maitũ |njĩra|inĩ
  ya | thayũ.
  Ithe witũ arogoocwo |o na | Mũriũ: o |
  Na Ro|ho Mũ|theru.

  O ta ũrĩa gwatariĩ kĩambĩrĩria, na ũrĩa
  Gũ|tariĩ | rĩu: na ũrĩa gũgatuĩka hingo
  Ciothe, tene na | tene,| A|men.
