Ngoro Yakwa Nĩĩrakumia Mwathani:(377)
(Magnificat)

1.Ngoro yakwa nĩĩraku|mia Mwa|thani:
  Naguo roho wakwa nĩũkeneire Ngai | Mũho|nokia|
  Wakwa.

2.Nĩ ũndũ | nĩaro|rete: ũrĩa ngombo yake ya mũirĩtu |
  Ĩĩnyi|hĩtie:

3.Tondũ rĩrĩ, | kuuma | rĩu: njiaro ciothe nĩirĩ|ndua|ga
  Mũkenu.

4.Nĩ gũkorũo ũrĩa Mũhoti nĩanjĩkĩte ma|ũndũ ma|nene:
  Narĩo rĩĩtwa | rĩake | nĩ rĩ|theru.

5.Nacio tha ciake ikinyagĩra | njiaro na |njiaro: cia
  Arĩa |mamwĩ|tiga|gĩra.

6.Nĩekĩte maũndũ ma hinya na | guoko | gwake: na
  Arĩa metĩĩte, nĩamaha-raganĩtie nĩ ũndũ wa
  Mwĩgere|ro wa| ngoro | ciao.

7.Nĩarutĩte aathani itĩinĩ ciao cia | ũtha|maki: na
  agatũ|gĩria a|rĩa a|hũthũ.

8.Nĩahũnĩtie arĩa ahũtu | irio |njega: nacio
  Itonga nĩaciinga|tĩte i|tarĩ na | kĩndũ.

9.Nĩateithĩtie Isiraeli, ndu|ngata | yake:
  Aririkaine ũhoro wake wa kũigu|anĩ|rat ha.

10.O ta ũrĩa erĩire | maithe | maitũ: atĩ nĩakaiguĩra
  Iburahimu tha o na njiarwa ciake | nginya |
  Tene na | tene.

  Ithe witũ arogoocwo | o na |Mũriũ: o | na
  Ro|ho Mũ|theru.
  O ta ũrĩa gwatariĩ kĩambĩrĩria, na ũrĩa gũ|tariĩ
  | rĩu: na ũrĩa gũgatuĩka hingo ciothe, tene na
  | tene, | A|men.

                    Luk 1:46-55
