Nĩtũgũkũgooca Ngai(374)
(Te Deum Laudamus)

1.Nĩtũgũkũ | gooca |Ngai: na
  Tũgwĩtĩkĩra atĩ we | wĩ Mwa|thani | witũ.

2.Thĩ ĩno yothe nĩĩ|gũkũ|gooca: we Ithe witũ
  | wa te|ne na | tene.

3.Araika othe nĩmegũ| kwanĩ|rĩra: narĩo
  Igũrũ, o na mahinya mo|the ma|rĩa ma|rĩ
  Kuo.

4.Akerubi | na Athe|rabi: nĩmakwa|nagĩrĩra
  Hĩndĩ |ciothe | maki|ugaga.

5.Mũtheru, Mũthe|ru, Mũthe|ru: Jehova
  Ngai Mũ|nene | wa Ita.

6.Igũrũ na thĩ kũiyũrĩte ũnene wa | Ngumo |
  Yaku: gĩkundi kĩrĩa gĩku-mĩtio gĩa
  Atũmwo | nĩgĩ| gũkũ|gooca.

7.Thiritũ ĩrĩa njega ya anabii nĩĩ|
  Gũkũ|gooca: mbũtũ ĩrĩa njega ya aira
  Athe|ru nĩĩ|gũkũ|gooca:

8.Kanitha Mũtheru ũrĩa wĩ thĩ yothe
  Nĩgũ|gwĩtĩ|kĩra: Ithe witũ wa ũnene |
  Ũta|ngĩge|reka.

9.Na Mũrũguo ũrĩa mũtĩ|e na | wa ma: ni|ngĩ
  Ũ|rĩa wa mũmwe.

10.O nake Ro|ho Mũ|theru: ũ|rĩa
  Mũ|hore|rania.

11.We,wĩ Mũthamaki | wa ũ|nene:We|-|-|,
  Kristũ.

12.We nĩwe Mũrũ wa |Ithe |witũ:na wĩ |wa
  Te|ne na | tene.

13.Rĩrĩa wetĩkĩrire gũkũria ciana | cia A|damu:
  Ndũamenire |nda ya | mũiri|tu ũcio.

14.Rĩrĩa watoririe ru|o rwa |gĩkuũ:
  Nĩwahingũrĩire ũthamaki wa Igũrũ
  Arĩa |othe |metĩ|kĩtie..

15.We ũikaire guokoinĩ kwa ũ|rĩo kwa | Ngai:
   Ũnene|inĩ wa |Ithe |witũ.

16.Nĩtũgwĩtĩkia atĩ | nĩũ|goka: gũtuĩ|ka
  Mũciri|thania:

17.Nĩ ũndũ ũcio nĩtũgũgũthaitha, ũtũteithie ithuĩ
  Ndu|ngata | ciaku:iria wakũũrire na thaka|me
  Ya|ku ya | bata.

18.Na ũtũme tũtaranĩrio na andũ a|ku
  Aa|mũre:ũneneinĩ ũrĩa | wa te|ne na |tene.

19.Mwathani, gitĩra |andũ | aku: na ũrathime
  Cia|na cia|ku nya|mũre.

20.ũ|cia|the: na ũcitũgĩ|rie te|ne na | tene.

21.Mĩthenya yothe nĩtũrĩ |kũga |thaga:na
  Nĩtũrĩgoocaga Rĩĩtwa rĩa|ku te|ne na | tene.

22.ĩtĩkĩra, Mwathani, gũtũikaria ũmũthĩ|
  Tũti|kehie: Mwathani, tũigu|ĩre tha, | tũiguĩ|re
  Tha.

23.Mwathani, ũtũme tha ciaku ciikũrũke ciũmbe
  I|guru | riitũ: o ta ũrĩa tũ|kwĩho|kete |we.

24.Mwathani, nĩngwĩho|kete | we:ũgirie |
  Ngathĩ|nio o na rĩ.

                 Kũg 4
