ũkani Tũkũngũiye Jehova Tũkenete(373)
(Venite exultemus)

1.ũkani tũkũngũyie Jehova | tũke|nete: tũkĩanĩrĩre
  Ndũmba iitũ ya ihiga, yo nyene |ũho|nokio witũ.

2.Nĩtũkinye ũthiũinĩ wake |twĩ na |ngatho:
  Tũmwanĩrĩre na gĩkeno tũkĩinaga | nyĩmbo |cia
  Tha|buri.

3.Nĩ gũkorũo Jehova nĩ Mũru|ngu mũ|nene:na nĩ
  Mũthamaki mũnene
  Ũkĩ|rĩte| ngai| ciothe.

4.Thĩ thĩinĩ kũrĩa kũriku kũrĩ o rũ|hĩinĩ|rwake:
  Gwata mĩthia ya irĩma | o na|yo no | yake.

5.Iria nĩ rĩake, rĩrĩa inene, nĩwe watũ|mire |rĩgĩe:
  Moko make nomo mombire | thĩ gũ|kũ kũ|niaru.

6.Gĩũkeni, tũmũthathaiye, tũmũi| namĩ| rĩre:
  Nĩtũturĩrie Jehova ndu,| o ũ|cio Mũ|tũmbi.

7.Nĩ gũkorwo we nĩwe |Ngai| witũ: na nĩ ithuĩ
  Kĩrĩndĩ gĩake kwĩrĩithĩria, nĩ ithuĩ ng’ondu iria
  Atuungata|ga na |guoko| gwake.

8.ũmũthĩ na arĩ korũo mwetĩkĩra kũigua mũgambo
  Wake! Tigai kũũmia | ngoro| cianyu: ta ũrĩa
  Mwekire kũu Meriba, mũthĩ ta ũrĩa mwarĩ | Masa,|
  Kũu we|rũinĩ.

9.Hĩndĩ ĩrĩa maithe manyu| maange|ririe:makĩndoria,
  Na magi|kĩona | wĩko |wakwa.

10.Ndatũũire njitĩte ngoro mĩaka mĩrongo ĩna nĩ
  Rũciaro| rũu, ngĩ||kiuga: Aya nĩ kĩruka kĩa ngoro
  Nyũngũtũki na njĩra ciakwa nĩmare|gete|
  Gũci|menya.

11.Ngĩkĩĩhĩta nĩ ũrĩa ndakaire, |ngiuga a|tĩrĩ:
  Matigatonya Kĩ|hurũ|koinĩ| gĩakwa.
  Ithe witũ arogoocwo | o na |
  Mũriũ: o | na Ro|ho Mũ|theru. O ta ũrĩa gwatariĩ
  Na ũrĩa gũ|tariĩ rĩu:na ũrĩa gũgatuĩka hingo ciothe,
  Tene na|tene,|A|men.
                           Thab 95
